13 19 30 0 0 0 0 0 0 0 0 0 0 0 0 0
0 0 0 0 0 0 0 0 7 7 7 7 7 0 0 0  
0 0 0 0 0 0 0 0 7 0 0 0 7 0 0 0
0 0 0 0 0 0 0 0 7 4 0 0 7 0 0 0
0 0 0 0 0 0 0 0 7 7 7 7 7 0 0 0
0 0 0 0 0 0 0 0 0 0 0 0 0 0 0 0
0 0 21 19 18 0 0 0 0 0 0 0 0 0 0 0
0 0 0 0 0 0 0 0 1 0 0 0 3 0 0 0
0 0 0 0 0 0 0 0 0 0 0 0 0 0 0 0
0 0 0 0 0 0 0 0 0 0 0 0 0 0 0 0
0 0 28 0 0 0 0 0 0 10 10 10 10 10 0 0
0 0 19 0 0 5 0 0 0 10 0 0 0 10 0 0
0 0 27 0 0 0 0 0 0 10 10 10 10 10 0 0
0 0 25 0 0 9 0 0 0 0 0 0 0 0 0 0
0 0 19 0 0 0 16 19 29 0 0 0 0 0 0 0
0 0 14 0 0 0 0 0 0 0 0 0 0 0 0 0