13 17 25 0 0 0 0 0 0 0 0 0 0 0 0 0
0 0 0 0 0 0 0 0 7 7 7 7 7 0 0 0  
0 0 0 0 0 0 0 0 7 0 0 0 7 0 0 0
0 0 0 0 0 0 0 0 7 4 0 0 7 0 8 0
0 0 23 0 0 0 0 0 7 7 7 7 7 0 0 0
0 0 17 0 0 0 0 0 0 0 0 0 0 0 0 0
0 0 18 17 16 0 0 0 0 0 0 0 0 0 0 0
0 0 0 0 0 0 0 1 0 0 0 0 3 0 0 0
0 0 0 0 0 0 0 0 0 0 0 0 0 0 0 0
0 0 0 0 0 0 0 0 0 0 0 0 0 0 0 0
0 0 23 0 0 0 0 0 0 10 10 10 10 10 0 0
0 0 17 0 0 5 0 0 0 10 0 6 0 10 0 0
0 0 22 0 0 0 0 0 0 10 10 10 10 10 0 0
0 0 21 0 0 9 0 0 0 0 0 0 0 0 0 0
0 0 17 0 0 0 15 17 24 0 0 0 0 0 0 0
0 0 14 0 0 0 0 0 0 0 0 0 0 0 0 0