0 10 25 19 24 10 0 0 7 7 7 28 19 27 7 7
0 0 10 10 10 0 0 9 0 7 7 7 9 7 7 0  
13 0 0 0 0 0 9 1 0 0 10 0 7 7 9 0
19 0 0 0 0 0 0 0 9 0 10 0 0 0 7 0
30 0 0 0 0 0 0 9 0 0 10 0 30 0 7 4
0 0 0 0 9 0 0 0 0 0 10 0 0 0 0 7
0 0 0 0 0 0 0 9 9 0 3 0 0 0 0 0
0 25 19 23 0 0 0 0 0 0 5 10 0 0 0 0
0 0 0 0 0 0 0 5 5 5 5 10 0 0 0 0
0 0 0 0 0 0 5 0 10 10 10 10 10 10 10 10
0 0 0 0 0 0 0 5 0 0 0 0 10 21 19 18
0 0 0 8 0 0 0 5 0 21 0 0 10 15 19 26
0 0 5 0 0 0 0 5 0 0 0 0 10 10 10 10
0 0 5 5 0 0 0 5 0 0 0 0 0 0 0 0
0 0 0 0 5 5 5 5 0 0 0 0 0 25 0 0
0 0 0 0 0 0 0 0 0 0 0 0 0 16 19 29