0 10 9 19 24 10 0 0 7 7 7 7 7 7 7 7
0 0 10 10 10 0 0 0 0 7 7 7 7 7 7 0  
13 0 0 0 0 0 0 1 0 0 10 0 7 7 9 0
19 0 0 0 0 0 0 0 0 0 10 0 0 0 0 0
30 0 0 0 0 0 0 0 0 0 10 0 30 0 0 0
0 0 0 0 0 0 0 0 0 0 10 0 0 0 0 0
0 0 0 0 0 0 0 0 0 0 3 0 0 0 0 0
0 0 0 0 0 0 0 0 0 0 5 10 0 0 0 0
0 0 0 0 0 0 0 5 5 5 5 10 0 0 0 0
0 0 0 0 0 0 5 0 10 10 10 10 0 0 0 0
0 0 0 0 0 0 0 5 0 0 0 0 0 0 0 0
0 0 0 8 0 0 0 5 0 21 0 0 0 0 0 0
0 0 5 0 0 0 0 5 0 0 0 0 0 0 0 0
0 0 5 5 0 0 0 5 0 0 0 0 0 0 0 0
0 0 0 0 5 5 5 5 0 0 0 0 0 17 0 0
0 0 0 0 0 0 0 0 0 0 0 0 0 0 0 0