9 13 21 0 0 0 0 0 0 0 0 0 0 0 0 0
0 0 0 0 0 0 0 0 4 4 4 4 4 0 0 0  
0 0 0 0 0 0 0 0 4 0 0 0 4 0 0 0
0 0 0 0 0 0 0 0 4 3 0 0 4 0 0 0
0 0 0 0 0 0 0 0 4 4 4 4 4 0 0 0
0 0 0 0 0 0 0 0 0 0 0 0 0 0 0 0
0 0 14 13 12 0 0 0 0 0 0 0 0 0 0 0
0 0 0 0 0 0 0 1 0 0 0 0 0 0 0 0
0 0 0 0 0 0 0 0 0 0 0 0 0 0 0 0
0 0 0 0 0 0 0 0 0 0 0 0 0 0 0 0
0 0 19 0 0 0 0 0 0 6 6 6 6 6 0 0
0 0 13 0 0 5 0 0 0 6 0 0 0 6 0 0
0 0 18 0 0 0 0 0 0 6 6 6 6 6 0 0
0 0 17 0 0 0 0 0 0 0 0 0 0 0 0 0
0 0 13 0 0 0 11 13 20 0 0 0 0 0 0 0
0 0 10 0 0 0 0 0 0 0 0 0 0 0 0 0