23 17 22 10 0 0 0 0 0 0 0 0 0 0 0 0
13 17 25 10 0 0 0 0 0 0 0 0 0 0 0 0  
15 17 24 10 0 0 0 0 0 0 0 0 0 0 0 0
10 10 10 10 0 0 0 0 0 0 0 0 0 0 8 0
0 0 0 0 0 0 0 0 0 0 0 0 0 0 0 0
0 0 0 0 0 0 0 0 0 0 0 0 0 0 0 0
0 0 0 0 0 0 0 0 0 0 0 0 0 0 0 0
0 0 0 0 0 0 0 1 0 0 0 0 0 0 0 0
0 0 5 0 0 0 0 0 0 0 0 0 0 0 0 0
0 0 0 5 0 0 5 0 0 0 0 0 0 0 0 0
0 0 0 0 0 0 0 0 0 10 10 10 10 10 0 0
0 0 0 0 0 0 0 0 0 0 3 3 4 10 0 0
0 0 0 0 0 0 0 0 0 10 10 10 10 10 0 0
0 0 0 0 0 0 0 0 0 0 0 0 0 0 0 0
0 0 0 0 0 0 0 0 0 0 0 0 0 0 0 0
0 0 0 0 0 0 0 0 0 0 0 0 0 0 0 0