0 5 0 5 5 5 0 0 0 0 0 0 0 0 0 0
0 5 0 5 0 5 0 0 0 0 0 0 0 0 0 0
0 5 0 5 0 5 0 13 19 30 0 0 0 0 0 0
0 5 0 5 5 5 0 16 19 29 0 0 0 0 0 0
0 5 0 5 0 0 0 0 0 0 0 0 0 0 0 0
0 5 0 5 0 0 5 5 5 5 0 0 0 0 0 0
0 8 0 8 0 8 5 0 0 5 0 0 0 0 0 0
1 0 0 0 0 0 0 3 4 5 0 0 0 0 0 0
0 0 8 0 8 0 0 5 5 5 0 0 0 0 0 0
0 0 0 0 5 5 0 0 0 0 0 0 0 0 0 0
0 0 0 0 5 5 0 0 0 0 0 0 0 0 0 0
0 0 0 0 0 0 0 0 0 0 0 0 0 0 0 0
0 0 0 0 0 0 0 0 0 0 0 0 0 0 0 0
0 0 0 0 0 0 0 0 0 0 0 0 0 0 0 0
0 0 0 0 0 0 0 0 0 0 0 0 0 0 0 0
15 19 26 0 0 0 0 0 0 0 0 0 0 0 0 0