0 0 0 16 19 30 0 0 0 0 0 0 0 0 0 21
0 10 10 10 10 10 10 10 10 7 7 7 7 7 7 19  
0 10 0 0 0 0 0 0 7 0 0 0 0 0 7 14
0 10 10 10 10 10 10 10 10 0 16 0 0 0 7 7
10 0 0 0 0 0 0 0 0 0 0 0 0 0 0 0
0 0 0 0 0 0 0 0 0 13 19 30 0 0 0 0
0 0 0 1 0 28 19 27 10 0 0 0 0 0 0 0
0 0 19 0 0 0 0 0 0 0 7 0 0 0 0 0
29 0 0 0 10 0 0 0 0 0 7 0 0 0 0 0
10 10 10 10 10 10 10 10 10 10 10 0 0 0 0 0
0 0 0 0 0 0 0 0 0 0 0 0 0 0 0 0
0 0 0 0 0 0 0 0 0 0 0 0 0 0 0 0
0 0 0 0 0 0 0 0 0 0 0 0 0 0 0 0
0 0 0 0 0 0 0 0 0 0 0 0 0 0 0 0
0 0 0 0 0 0 0 0 0 0 0 0 0 0 0 0
0 0 0 0 0 0 0 0 0 0 0 0 0 0 0 0