28 19 27 10 0 0 0 0 0 0 0 0 0 0 0 0
13 19 30 10 0 0 0 0 0 0 0 0 0 0 0 0  
15 19 27 10 0 0 0 0 10 3 10 10 10 10 0 0
10 10 10 10 0 0 0 0 10 0 0 0 0 10 0 0
0 0 0 0 0 0 0 0 10 0 0 6 0 10 0 0
0 0 0 0 0 0 0 0 10 1 0 0 0 10 0 0
0 0 0 0 0 0 0 0 10 10 10 10 10 10 0 0
0 0 0 0 0 0 0 0 0 0 0 0 0 0 0 0
0 0 5 0 0 0 0 0 0 0 0 0 0 0 0 0
0 0 0 5 0 0 5 0 0 0 0 0 0 0 0 0
0 0 0 0 0 0 0 0 0 10 10 10 10 10 0 0
0 17 0 0 0 0 0 0 0 0 3 3 4 10 0 0
0 0 0 0 0 0 0 0 0 10 10 10 10 10 0 0
0 0 0 0 0 19 0 0 0 0 0 0 0 0 0 0
0 0 0 0 0 0 0 0 20 0 0 0 0 0 0 0
0 0 0 15 19 26 0 0 0 0 16 19 29 0 0 0