0 0 0 16 19 30 0 0 0 0 0 0 0 0 0 21
0 10 10 10 10 10 10 10 10 0 7 7 7 7 7 19  
0 10 4 0 0 0 0 0 7 0 0 0 0 0 7 14
0 10 10 10 10 10 10 10 10 0 16 0 0 0 7 7
10 0 0 0 0 0 0 0 0 0 0 0 0 0 0 0
0 0 0 0 0 0 0 0 0 0 0 30 0 0 0 0
0 0 0 1 0 0 0 0 10 0 0 0 0 0 0 0
0 0 19 0 0 0 0 0 0 0 0 0 0 0 0 0
0 0 0 0 10 0 0 0 0 0 0 0 0 0 0 0
10 10 10 10 10 10 10 10 10 10 10 0 0 0 0 0
0 0 0 0 0 0 0 0 0 0 0 0 0 0 0 0
0 0 0 0 0 0 0 0 0 0 0 0 0 0 0 0
0 0 0 0 0 0 0 0 0 0 0 0 0 0 0 0
0 0 0 0 0 0 0 0 0 0 0 0 0 0 0 0
0 0 0 0 0 0 0 0 0 0 0 0 0 0 0 0
0 0 0 0 0 0 0 0 0 0 0 0 0 0 0 0