14 18 26 0 0 0 0 0 0 0 0 0 0 0 0 0
0 0 0 0 0 0 0 0 7 7 7 7 7 0 0 0  
0 0 0 0 0 0 0 0 7 0 0 0 7 0 0 0
0 0 0 0 0 0 0 0 7 4 0 0 7 0 0 0
0 0 24 0 0 0 0 0 7 7 7 7 7 0 0 0
0 0 18 0 0 0 0 0 0 0 0 0 0 0 0 0
0 0 19 18 17 0 0 0 0 0 0 0 0 0 0 0
0 0 0 0 0 0 0 1 0 0 0 0 3 0 0 0
0 0 0 0 0 0 0 0 0 0 0 0 0 0 0 0
0 0 0 0 0 0 0 0 0 0 0 0 0 0 0 0
0 0 24 0 0 0 0 0 0 11 11 11 11 11 0 0
0 0 18 0 0 5 0 0 0 11 0 0 0 11 0 0
0 0 23 0 0 0 0 0 0 11 11 11 11 11 0 0
0 0 22 0 0 10 0 0 0 0 0 0 0 0 0 0
0 0 18 0 0 0 16 18 25 0 0 0 0 0 0 0
0 0 15 0 0 0 0 0 0 0 0 0 0 0 0 0